--tttttttttttttt
--t-----!------t
--t-----2------t
--t-----h------t
--t------------t
--t-----p------t
--tttttttttttttt