l-------------i
ttttttttttttttt
t-s------ptttttt
t-------------t
tqBBqBqbBb-BB-t
t-------------t
t-w-----h-----t
ttttttttttttttr
-------^------1